胡歌	[前女友]: 薛佳凝 江疏影	[好友]: 霍建华 古力娜扎 白冰
江疏影	[前男友]: 胡歌	[好友]: 赵霁	[搭档]: 杨子姗
霍建华	[妻子]: 林心如	[哥哥]: 霍建元	[好友]: 胡宇威 胡歌 杨幂
白冰	[丈夫]: 丁一	[好友]: 胡歌	[搭档]: 杨凯淳 王琳
薛佳凝	[前男友]: 胡歌	[好友]: 刘璇 罗海琼	[搭档]: 陈好
林心如	[丈夫]: 霍建华	[前男友]: 林志颖	[妹妹]: 林艾为	[好友]: 唐季礼 蔡君茹 秦海璐
杨子姗	[丈夫]: 吴中天	[好友]: 薛凯琪 陈意涵 郭碧婷
杨幂	[丈夫]: 刘恺威	[女儿]: 小糯米	[父亲]: 杨晓林	[公公]: 刘庆基	[婆婆]: 李馥莹	[伯伯]: 杨晓京	[好友]: Angelababy 赵姝婷
唐季礼	[好友]: 林心如	[同学]: 周华健
古力娜扎	[前男友]: 张翰	[好友]: 刘诗诗 胡歌	[搭档]: 刘烨
刘璇	[丈夫]: 王弢	[好友]: 薛佳凝	[搭档]: 张靓颖	[队友]: 叶琳琳
刘恺威	[妻子]: 杨幂	[女儿]: 小糯米	[前女友]: 廖碧儿	[父亲]: 刘庆基	[母亲]: 李馥莹	[岳父]: 杨晓林	[搭档]: 陶辰宇 文梦洋 杨菲洋
周华健	[妻子]: 康粹兰	[女儿]: 周厚恩	[儿子]: 周厚安	[好友]: 任贤齐 辛晓琪 苏慧伦
罗海琼	[丈夫]: 费麒	[好友]: 薛佳凝	[搭档]: 张子嫣 陈好
王弢	[妻子]: 刘璇	[父亲]: 王茂俊
任贤齐	[好友]: 许杰辉 周华健 李宗盛
王琳	[好友]: 雷濛	[搭档]: 郭艳 白冰
杨凯淳	[搭档]: 白冰 蔡少芬
Angelababy	[丈夫]: 黄晓明	[儿子]: 小海绵	[前男友]: 陈伟霆	[弟弟]: 杨帆	[公公]: 黄境清	[婆婆]: 张素霞	[好友]: 杨幂 韩火火	[搭档]: 程皓枫
张靓颖	[丈夫]: 冯轲	[母亲]: 张桂英	[好友]: 崔迪 郭晶晶 谭维维
陈好	[丈夫]: 刘海峰	[同学]: 贾一平 李宗翰 吴健
秦海璐	[丈夫]: 王新军	[前男友]: 李厚霖	[堂妹]: 秦子涵	[好友]: 李冰冰 林心如
费麒	[妻子]: 罗海琼	[前女友]: 孔维	[同学]: 王菲
丁一	[妻子]: 白冰
薛凯琪	[前男友]: 房祖名	[好友]: 林瑞瑜 蒋勤勤 陈意涵
周厚恩	[父亲]: 周华健	[母亲]: 康粹兰	[哥哥]: 周厚安
薛佳凝	[前男友]: 胡歌	[好友]: 刘璇 罗海琼	[搭档]: 陈好
蔡少芬	[丈夫]: 张晋	[女儿]: 张信儿 张楚儿	[好友]: 宣萱 朱茵 陈法蓉
黄晓明	[妻子]: angelababy	[儿子]: 小海绵	[前女友]: 刘立淇 秦岚 李菲儿	[父亲]: 黄境清	[母亲]: 张素霞	[表妹]: 陈梦	[好友]: 杜淳
谭维维	[好友]: 曾一鸣 关喆 杨幂
陶辰宇	[好友]: 黄龄	[搭档]: 陈嘉桦 刘恺威
程皓枫	[搭档]: 张家辉 胡歌 Angelababy
林志颖	[妻子]: 陈若仪	[儿子]: 小小志	[前女友]: 柯佳青 林心如	[父亲]: 林德雄	[弟弟]: 林志龙	[好友]: 韩晶 杨蕊 林俊杰
刘烨	[妻子]: 安娜伊思·马田	[女儿]: 刘霓娜	[儿子]: 刘诺一	[前女友]: 谢娜	[好友]: 吴彦祖	[搭档]: 于娜 李佳璇
蔡君茹	[丈夫]: 李翊	[好友]: 林心如 黄小柔 林依晨
房祖名	[前女友]: 戴佩妮	[父亲]: 成龙	[母亲]: 林凤娇	[爷爷]: 房道龙	[表弟]: 董又霖	[伯伯]: 房仕胜 房仕德
陈伟霆	[前女友]: angelababy 蔡卓妍	[好友]: 李易峰 张杰	[搭档]: 张致恒
李宗盛	[女儿]: 李喜儿	[前妻]: 朱卫茵 林忆莲	[姐姐]: 张艾嘉	[好友]: 刘若英 任贤齐 张信哲
曾一鸣	[好友]: 谭维维 金池	[老师]: 涂惠源
胡宇威	[好友]: 罗弘证 飞轮海 班杰
秦岚	[前男友]: 陆川 黄晓明	[好友]: 初俊辰 姚笛 刘云
刘庆基	[妻子]: 李馥莹	[儿子]: 刘恺威	[孙女]: 小糯米	[儿媳]: 杨幂	[亲家公]:  杨晓林 
刘恺威	[妻子]: 杨幂	[女儿]: 小糯米	[前女友]: 廖碧儿	[父亲]: 刘庆基	[母亲]: 李馥莹	[岳父]: 杨晓林	[搭档]: 陶辰宇 文梦洋 杨菲洋
Angelababy	[丈夫]: 黄晓明	[儿子]: 小海绵	[前男友]: 陈伟霆	[弟弟]: 杨帆	[公公]: 黄境清	[婆婆]: 张素霞	[好友]: 杨幂 韩火火	[搭档]: 程皓枫
吴健	[同学]: 陈好 贾一平
刘诗诗	[丈夫]: 吴奇隆	[好友]: 徐正溪 胡歌 叶祖新
蒋勤勤	[丈夫]: 陈建斌	[前男友]: 李大为	[好友]: 薛凯琪	[搭档]: 胡雅斯 王学圻
赵霁	[好友]: 江疏影	[搭档]: 金世佳 卓文萱
秦子涵	[堂姐]: 秦海璐
陈意涵	[丈夫]: 许富翔	[前男友]: 谢坤达	[好友]: 薛凯琪 杨子姗 陈柏霖
蔡卓妍	[前夫]: 郑中基	[前男友]: 陈伟霆	[父亲]: 蔡就胜	[好友]: 郑欣宜 陈慧琳 钟欣潼
杨幂	[丈夫]: 刘恺威	[女儿]: 小糯米	[父亲]: 杨晓林	[公公]: 刘庆基	[婆婆]: 李馥莹	[伯伯]: 杨晓京	[好友]: Angelababy 赵姝婷
廖碧儿	[前男友]: 刘恺威	[搭档]: 陈豪
柯佳青	[前男友]: 林志颖
吴中天	[妻子]: 杨子姗	[搭档]: 周宜霈 张晨光 傅天颖
郭碧婷	[好友]: 曾轶可 陈匡怡 林孝谦
张艾嘉	[丈夫]: 王靖雄	[儿子]: 王令尘	[前男友]: 罗大佑	[弟弟]: 李宗盛	[学生]: 刘若英
姚笛	[前男友]: 迟帅	[好友]: 秦岚	[搭档]: 李依玲 艾如
张杰	[妻子]: 谢娜	[前女友]: 段曦	[好友]: 陈伟霆 曹轩宾 常石磊
成龙	[妻子]: 林凤娇	[儿子]: 房祖名	[前女友]: 吴绮莉	[父亲]: 房道龙	[哥哥]: 房仕胜 房仕德	[义父]: 罗维 于占元	[外甥]: 董又霖
陈柏霖	[前女友]: 刘碧丽	[好友]: 鹿晗 房祖名	[搭档]: 陈匡怡
胡歌	[前女友]: 薛佳凝 江疏影	[好友]: 霍建华 古力娜扎 白冰
杨菲洋	[好友]: 刘恺威 王鸥	[搭档]: 菅纫姿
初俊辰	[好友]: 秦岚
陈建斌	[妻子]: 蒋勤勤	[前女友]: 吴越	[好友]: 张译 王学兵	[搭档]: 高希希
金世佳	[搭档]: 李佳航 赵霁 李金铭
张译	[好友]: 兰晓龙 王宝强 梁静
许杰辉	[好友]: 任贤齐
吴彦祖	[妻子]: Lisa Selesner	[女儿]: 吴斐然	[前女友]: 李美琪	[好友]: 古天乐 刘烨 冯德伦
王靖雄	[妻子]: 张艾嘉	[儿子]: 王令尘
孔维	[前男友]: 费麒	[搭档]: 姜文	[同学]: 郭晓东 黄晓明
杜淳	[父亲]: 杜志国	[好友]: 黄晓明	[搭档]: 葛优	[老师]: 陈浥
谭维维	[好友]: 曾一鸣 关喆 杨幂
徐正溪	[好友]: 邹廷威 江若琳 刘诗诗
李金铭	[搭档]: 李佳航 刘萌萌 李智楠
刘若英	[丈夫]: 钟小江	[爷爷]: 刘咏尧	[好友]: 汤唯 陈鲁豫 李大齐
